111111111111111111111211
100000000000001000000001
100111111011111011111101
100010000010000010000001
111010111010111110101101
100010101010100010101001
101111101011101011101111
100000100000100000100001
111111101110101111101101
100000101000100000101001
111011111011111011111011
100000000000000000000001
101111111011101111111101
100000001000100000001001
111111101011111101111111
100010101000100000101001
101000001111111111101111
100010101000000001001001
101111101011111011111111
100111000000000000000001
111111111111101011111101
100000000000000000001001
103101111111101111111001
111111111111111111111111