111211111111111111111111
100000001000000010000001
100011101111101011101101
100000100010001000000001
101111101110111011111101
100000000000000000000001
111111111011111011111111
100000000000001000000001
111111101111101011111111
100000100000001000000001
101111101111111011111101
100000100000001000000001
111111111011101011111111
100010000010000010000001
101110111111111011101101
100000100000100000000001
111101101011101011111111
100000000000000000000001
111101111111101111111101
100000000010000010000001
111111111011111011111101
100000000000000000000001
100111111011111011110301
111111111111111111111111