11111111111111111111111
100000000000000000000001
201111100011011110000001
100000100000000010000001
110000111111100010000001
110010100000101110000001
110010100000101111000001
111110000000100001000001
100000000000111111000001
100000000000000000000001
100000000000000000000001
100000001111000000000001
100000000001000000000001
100000001111000000000001
100000001000000000000001
100000001001111111000001
111110001001011101000001
100010001001000101000001
100010001001001101000001
100010001001001111000001
100010001001000000000001
101110001001000000000001
100000001111000000000001
111111111111111111111111
