111111111111111111111111
100010000010000010000001
111010111011101110111101
100010001010001000010001
101111111011111011111101
100000001010001000000001
111111101110111011101111
100010001000100010001001
111010111111111011101101
100010000000000010001001
111111111011111011111101
100000000000100000000001
111111111111111111111111
100000000000000000000001
101111111011111011111101
100000000000100000000001
111011101111111110111111
100010000000100000010001
111111101111101111101101
100000000010000000000001
111111111111111111111101
100000000000000000000001
100111111011111011111001
111111111111111111111211
