121111111111111111111111
100000000000000000000001
100000000000000000000001
100000001000000100000101
100000000000000000000101
100000001000000100000101
100000001000000100000001
100000001000000100000001
100000000000000100000001
100000000000010001000001
100000000000000000000001
100000000000010000000001
101110100000000000100001
100000100000000000000001
111000000000000000000001
100000001000000010000001
100000001000000010000001
100000000000000010000001
100000000000000000000001
100000001000000000000001
100000001000000000000001
100000000000000000000001
100000000000000000000001
111111111111111111111111