111111211111111111111111
100000000011000000000001
100111000011001110000001
100001000000000001000001
100000000000000000000001
101100000111000000011101
100000000000000000000001
101111100000000000111101
100000000000001000000001
100000000001111000000001
100111100000000011100001
100000011100000111000001
100000000000000000000001
100011000111110001100001
100000000000000000000001
100000000000000000000001
100000001111100011000001
100000000000000000000001
100000011110011111000001
100000000000000000000001
100111100000011100111001
100000000001000000000001
100000111100000011100001
111111111111111111111111
