111111111111112111111111
100000000000000000000001
111011111111110011111111
100010000000100010000001
101110111111111011101101
100000000000001000000001
111111101111111111111111
100010000010001000000001
111010111110111011111101
100010000000000010000001
111111111011111011111111
100000000000100000000001
101111111111101111111101
100000000000000000000001
111111111011111011111111
100000000000000000000001
101111111011101011111111
100000000010000000000001
111111101111101111101101
100000000000000000000001
111111101111111011111111
100000000000000000000001
101111111111101111111301
111111111111111111111111