111111111111111111111111
200000000000000000000001
101111110011100011111101
100000000000000000000001
100000000011111100000001
100000000000001000000001
101111000000000001111101
100000000111100000000001
101100000000000000000001
100000111111000000000001
100000000000000000000001
100111110000011111110001
100000000001000000000001
100000000011111111111101
100000000000000000000001
100111111100011111111001
100000000000000000000001
100000011111100011100001
100000000000000000000001
100000000000000000000001
100011111000011111111001
100000000000000000000001
100111111000000111111001
111111111111111111111111
