111111111111111111111111
100000000011000000000001
101111000000001111100001
100000000000000000000001
201111110000111111111001
100000000000000000000001
100000000011100000000001
100011111111111111111001
100000000000000000000001
100000011111000111100001
100000000000000000000001
101111000011000111111101
100000000000000000000001
100000000011100000000001
100000000000000000000001
101111111111111111110001
100000000000000000000001
100011111100000111110001
100000000000000000000001
100000000000000000000001
100011111111111111110001
100000000000000000000001
100011100000000011100001
111111111111111111111111
