111111111111111111111111
100010000010000010000001
101111101011111011101101
100000100010000010000001
111111101111111011111101
100010000000100000000001
111011111111101111101111
100000000000001000000001
111111111011101011111101
100010001000100010000001
101111101111111011111101
100000000000001000000001
111111101111101111101111
100000000010001000000001
111011111111111011111111
100000000000100000000001
101111111011111111111101
100000000000100000000001
111111111011111011111111
100010000010001000010001
101111101111101111111101
100000000000001000000001
101111111111101111111001
111111111111111111111211
