111111111111111111111211
100000000000000000000001
101111111011111011111101
100000000000000000000001
111111111111111111111101
100000000010001000000001
101111111011111011111101
100000000000000000000001
111011111111111111111111
100000000000000000000001
111111111011101011111111
100010001000001000010001
111111111111111011111111
100000000010000000000001
111011111011111011111101
100000000000000000000001
111111111111111111111101
100000001000000010000001
101111101011111011101101
100000000000000000000001
111111111011110000111101
100000000000000110000001
101111111011000110000001
111111111111112111111111