121111111111111111111111
100000000000000000000001
101111111100011111100001
100000000000000000000001
101110000000011000111101
100000000000000000000001
101111110000000011110001
100000000000000000000001
101111111100011111100001
100000000000000000000001
101110000000000011111001
100000000000000000000001
100000000111111100000001
100011111111100000000001
100000000000000011100001
100000000000000000000001
100000011111111000011101
100000000000000000000001
101111000000000011111101
100000000000000000000001
101111111111111111110001
100000000000000000000001
100111100000011100000001
111111111111111111111111
