111111111111111111111111
100000000000000000000001
101111111111111111110001
100000000000000000000001
100000000000111000000001
101111111111100111111001
100000000000000000000001
100000011111111000000001
200111111100000111111001
100000000000000000000001
101111111111111111110001
100000000000000000000001
100000000111111000000001
100011111000000111111001
100000000000000000000001
100000011111111000000001
100000000000000000000001
101111111111111111111001
100000000000000000000001
100011100000000011111101
100000000000000000000001
100000011111100011100001
111111000000000000000001
111111111111111111111111
