111111121111111111111111
100000000000000000000001
101111101111101011101111
100000100010001000000001
111111111011111011111101
100000000000000000000001
111111111011111011111111
100000100000000000100001
111111101111111011111101
100000000000001000000001
101111101111101111101111
100000100000001000000001
111111111111111111111101
100010000010000010000001
101111101111101111111101
100000000000001000000001
111111111111111111111101
100000001000000010000001
111011111111111011101101
100000000010001000000001
111111101111111011111111
100000000000000000000001
101111111111111111111001
111111111111111111111211