111111111111111112111111
100000000010000010000001
111111101111111111111101
100000100000000000100001
101111111111101111111101
100000000000001000000001
111111111111111011111101
100010000000000000000001
111111111011111111111111
100000100000100000100001
101111101111101111111111
100000100000000000000001
111111111111111011111111
100000000000000000000001
111011111011111111111111
100000000000000000000001
110111111111111111111101
100000000010000000000001
101111111011111111111111
100000000000000000000001
111111101111111011111101
100000000000000000000001
101111111011111011111001
111111111111111111111211