111111111111211111111111
100000000000000000000001
100111100000000011100001
100000000000000000000001
100111111111111111110001
100000000000000000000001
101111100000011000111101
100000000000000000000001
101111100000000111110001
100000000000000000000001
100011111000000111100001
100000000000000000000001
101111111111111111111101
100000000000000000000001
100011100000000011100001
100000000000000000000001
100111100000000011110001
100000000000000000000001
101111111111111111111101
100000000000000000000001
100000000111100000000001
101111100000000111100001
100000000000000000000001
111111111111111111111111
