111111111111111111111111
100000000000000000000001
100000111000000111000001
100000000000000000000001
101111111000000111111101
100000000000000000000001
100000111000000111000001
101111111100011111111101
100000000000000000000001
100000111100000111000001
100000000000000000000001
101111111000000111111101
100000000000000000000001
100000111100000111000001
100000000000000000000001
101111111111111111111101
100000000000000000000001
100000111000000111000001
100000000000000000000001
101111111000000111111101
100000000000000000000001
100000111100000111000001
111100001110000010000001
111111111111111111111111
