MAP1
111111111111111111111211
100000000000001000000001
100111111011111011111101
100010000010000010000001
111010111010111110101101
100010101010100010101001
101111101011101011101111
100000100000100000100001
111111101110101111101101
100000101000100000101001
111011111011111011111011
100000000000000000000001
101111111011101111111101
100000001000100000001001
111111101011111101111111
100010101000100000101001
101000001111111111101111
100010101000000001001001
101111101011111011111111
100111000000000000000001
111111111111101011111101
100000000000000000001001
100101111111101111111001
112111111111111111111111

MAP2
111211111111111111111111
100000001000000010000001
100011101111101011101101
100000100010001000000001
101111101110111011111101
100000000000000000000001
111111111011111011111111
100000000000001000000001
111111101111101011111111
100000100000001000000001
101111101111111011111101
100000100000001000000001
111111111011101011111111
100010000010000010000001
101110111111111011101101
100000100000100000000001
111101101011101011111111
100000000000000000000001
111101111111101111111101
100000000010000010000001
111111111011111011111101
100000000000000000000001
100111111011111011110001
111111111111111111111211

MAP3
111111111111111111111121
100010000010000010000001
111010111011101110111001
100010001010001000010001
101111111011111011111101
100000001010001000000001
111111101110111011101111
100010001000100010001001
111010111111111011101101
100010000000000010001001
111111111011111011111101
100000000000100011000001
111111111111110001111111
100000000000000000000001
101111111011111011111101
100000000000100000000001
111011101111111110111111
100010000000100000010001
111111101111101111101101
100000000010000000000001
101111111111111111111101
100000000000000000000001
100111111011111011111001
111111111111111111111211

MAP4
111111111111112111111111
100000000000000000000001
111011111111110011111111
100010000000100010000001
101110111111111011101101
100000000000001000000001
111111101111111111111111
100010000010001000000001
111010111110111011111101
100010000000000010000001
111111111011111011111111
100000000000100000000001
101111111111101111111101
100000000000000000000001
111111111011111011111111
100000000000000000000001
101111111011101011111111
100000000010000000000001
111111101111101111101101
100000000000000000000001
111111101111111011111111
100000000000000000000001
101111111111101111111001
111111111111111111111211

MAP5
111111111112111111111111
100010000010000010000001
101111101011111011101101
100000100010000010000001
111111101111111011111101
100010000000100000000001
111011111111101111101111
100000000000001000000001
111111111011101011111101
100010001000100010000001
101111101111111011111101
100000000000001000000001
111111101111101111101111
100000000010001000000001
111011111111111011111111
100000000000100000000001
101111111011111111111101
100000000000100000000001
111111111011111011111111
100010000010001000000001
101111101111101111111101
100000000000001000000001
101111111111101111111001
111111111111111111111211

MAP6
111111111111111111111211
100000000000000000000001
101111111011111011111101
100000000000000000000001
111111111111111111111101
100000000010001000000001
101111111011111011111101
100000000000000000000001
111011111111111111111111
100000000000000000000001
111111111011101011111111
100010001000001000010001
111111111111111011111111
100000000010000000000001
111011111011111011111101
100000000000000000000001
111111111111111111111101
100000001000000010000001
101111101011111011101101
100000000000000000000001
111111111011110000111101
100000000000000110000001
101111111011000110000001
111111111111112111111111

MAP7
111111121111111111111111
100000000000000000000001
101111101111101011101111
100000100010001000000001
111111111011111011111101
100000000000000000000001
111111111011111011111111
100000100000000000100001
111111101111111011111101
100000000000001000000001
101111101111101111101111
100000100000001000000001
111111111111111111111101
100010000010000010000001
101111101111101111111101
100000000000001000000001
111111111111111111111101
100000001000000010000001
111011111111111011101101
100000000010001000000001
111111101111111011111111
100000000000000000000001
101111111111111111111001
111111111111111111111211

MAP8
111111111111111112111111
100000000010000010000001
111111101111111111111101
100000100000000000100001
101111111111101111111101
100000000000001000000001
111111111111111011111101
100010000000000000000001
111111111011111111111111
100000100000100000100001
101111101111101111111111
100000100000000000000001
111111111111111011111111
100000000000000000000001
111011111011111111111111
100000000000000000000001
110111111111111111111101
100000000010000000000001
101111111011111111111111
100000000000000000000001
111111101111111011111101
100000000000000000000001
101111111011111011111001
111111111111111111111211

MAP9
111111111111121111111111
100000000000001000000001
111111101110111111111111
100010000010000000010001
101111111111101111111101
100000000000000000000001
111111101111111011111111
100000100000000000000001
101111111111111111111101
100000001000000010000001
111111111011111011111101
100010000000000000000001
101111111011111111111101
100000100000000000000001
111111111111111011111111
100000000000000000000001
111111111011111011111101
100000000010000010000001
101111101111111011101111
100000100000000000000001
111111111111011111111111
100000000010000000000001
101111111011111011111001
111111111111111111111211
