111111111111111111111111
100000000000000000000001
100000000000000000000001
100000001000000100000101
100000001111111100000101
100000001000000100000101
100000001000000100000001
100000001000000100000001
100000001110000100000001
100000000000010001000001
100000000000011111000001
100000000000010000000001
101110100000000111100001
100000100000000000000001
111011100000000000000001
100000001000000010000001
100000001000000010000001
111111111000000010000001
100000000000000000000001
100000001000000000000001
100000001000000000000001
111111111000000000000001
100000000000000000000001
111111111111111111111111
